 █████ ███████ ███████ ███ ███ ███████ █
█     █       █       █   █   █       █ █
█ █ █ █████ █ █ █████ █ █ █ ███ █ ███ █ █
█ █ █   █   █ █ █       █   █   █ █   █ █
█ █ ███ █ ███ █ █████ █████ █ ███ ███ █ █
█ █   █   █ █ █     █ █   █ █ █ █   █   █
█ ███ █████ █ █████ ███ █ ███ █ ███ ███ █
█   █     █ █     █ █   █   █ █   █ █   █
 ████████ █ █████ █ █ ██ ██ █ █ █ █ █ ██
█         █         █   █ █     █ █ █   █
█ █████████ ███████████ █ ███████ █ ███ █
█ █   █     █         █ █ █*****█ █   █ █
█ █ █ ███████ ███████ █ █ █*███*██ ██ █ █
█   █ █   █   █     █ █ █ █***█***█   █ █
█ ███ █ █ █ █████ █ █ █ █ ███*███*█ ███ █
█   █   █ █       █ █       █***█*█   █ █
 ██ █████ █ █████████████ █████*█*█ █ ██
█ █ █   █   █***********█ █*****█*█ █   █
█ █ █ ███████*█████████*███*█████*█████ █
█ █ █ █*******█ █     █***█*█   █*******█
█ █ █ █*███████ █ █ ██ ██*█*███ ███████*█
█ █ █ █***█       █ █O█***█*█     █*****█
█ █ █ ███*███ █████ █*█*███*█ █████*████
█       █***█     █ █***█***█*****█***█ █
█ █████████*█████ █ █████*███*███*███*█ █
█ █*********█   █ █    ***█***█ █*█***█ █
█ █*█████████ ███ █████*███*███ █*█*███ █
█ █***█ █     █   █   █*█***█   █***█   █
 ████*█ █ █ ███ ███ ███*█*█████ ████ ██ █
█***█*█   █ █   █   █***█*****█  ***█***█
█*█*█*█████ █ ███ ███*███████*███*█*█*█*█
█*█***█***█       █***█     █***█*█***█*█
█*█████*█*█████████*███ ████ ██*█*█████*█
█*█    *█*******█***█   █***█***█***█  *█
█*█████*███████*█*███ █ █*█*█*███ █*███*█
█*****█*******█*█*█   █ █*█***█   █***█*█
 ████*███████*█*█*█ ███ █*█████ █████*█*█
█ █***█***█***█***█ █ █ █*█     █***█*█*█
█ █*███*█*█*███████ █ █ █*███████*█*█*█*█
█  *****█***█         █  *********█***█X█
 ███████ ███ █████████ ███████████ ███ █
